#;#;#;#;#;#
#;x;-;-;-;#
#;-;@;-;-;#
#;-;-;-;-;#
#;#;-;-;-;#
#;+;+;@;-;#
#;#;#;#;#;#
