#;#;#;#;#;#
#;-;-;-;-;#
#;-;@;-;-;#
#;-;-;-;-;#
#;#;x;-;-;#
#;+;-;@;-;#
#;+;@;@;-;#
#;+;-;@;-;#
#;+;-;@;-;#
#;#;#;#;#;#
